11111
1CEP1
10001
100011
11111